---1-1-1---
--1012131--
--1012131--
-101010101-
-101010101-
10101010101
10101010101
-101010101-
-101010101-
--1010101--
--1010101--
---1-1-1---
